Google: جوجل
Google: قوقل
Facebook: فيسبوك
Twitter: تويتر
calories: كالوريز
Internet: إنترنت
email: إيميل
blog: بلوج
smartphone: سمارتفون
video: فيديو
login: لوجين
password: باسورد
website: ويبسايت
digital: ديجيتال
download: داونلود
online: أونلاين
chat: شات
hashtag: هاشتاج
laptop: لابتوب
server: سيرفر
software: سوفتوير
hardware: هاردوير
database: داتابيز
network: نتورك
security: سكيورتي
algorithm: ألغوريتم
analytics: أناليتكس
application: أبليكيشن
cloud: كلاود
coding: كودينج
cookie: كوكي
data: داتا
debug: ديباج
encryption: إنكريبشن
firewall: فايروول
firmware: فيرموير
gadget: جادجت
interface: إنترفيس
malware: مالوير
modem: مودم
pixel: بيكسل
protocol: بروتوكول
router: روتر
الrouter: الروتر
screenshot: سكرينشوت
sensor: سينسور
spam: سبام
spyware: سبايوير
template: تمبلت
widget: ويدجت
wifi: واي فاي
virus: فايروس
YouTube: يوتيوب
الYouTube: اليوتيوب
Instagram: إنستغرام
Instagram: إنستقرام
Snapchat: سنابشات
TikTok: تيك توك
LinkedIn: لينكدإن
WhatsApp: واتساب
Telegram: تلغرام
Zoom: زوم
Uber: أوبر
Spotify: سبوتيفاي
Netflix: نتفليكس
Amazon: أمازون
eBay: إيباي
PayPal: باي بال
Adobe: أدوبي
Photoshop: فوتوشوب
Excel: إكسل
Word: ورد
PowerPoint: باوربوينت
Android: أندرويد
iOS: آي أو إس
gamer: جيمر
streaming: ستريمينج
vlogging: فلوجينج
podcast: بودكاست
selfie: سيلفي
emoji: إيموجي
meme: ميم
viral: فايرال
bitcoin: بيتكوين
cryptocurrency: كريبتوكرنسي
blockchain: بلوكتشين
hacker: هاكر
phishing: فيشينج
ransomware: رانسوموير
startup: ستارت أب
entrepreneur: أنتربرينور
freelancer: فريلانسر
marketing: ماركيتنج
branding: براندينج
ecommerce: إيكومرس
SEO: سيو
UI: يو آي
UX: يو إكس
virtual: فيرتشوال
reality: ريالتي
augmented: أوجمنتد
AI: إيه آي
machine: ماشين
learning: ليرنينج
science: ساينس
big: بيج
computing: كمبيوتينج
IoT: آي أو تي
smart: سمارت
home: هوم
drones: درونز
3D: ثري دي
printing: برينتينج
sustainability: سستينابيليتي
renewable: رينيوابل
energy: إنرجي
electric: إلكتريك
vehicle: فيهيكل
solar: سولار
power: باور
wind: ويند
General: جنرال
ethics: إيثيكس
App: أب
Autonomous: أوتونوموس
Biohacking: بيوهاكينج
Biometrics: بيومتريكس
Collaborative: كولابوريتيف
Content: كونتنت
Cryptography: كريبتوجرافي
Cybersecurity: سايبرسكيورتي
Deep: ديب
bootcamp: بوتكامب
economy: إكونومي
intelligence: إنتلجنس
management: مانجمنت
mining: ماينينج
privacy: برايفسي
storage: ستوريج
store: ستور
system: سيستم
tech: تك
technology: تكنولوجي
vehicles: فيهيكلز
Disruptive: ديسربتيف
E-learning: إي ليرنينج
Edge: إدج
Electronic: إلكترونيك
Embedded: إمبيديد
Facial: فيشيال
Fintech: فينتك
Fitness: فيتنس
Flash: فلاش
Game: جيم
Geolocation: جيولوكيشن
Gesture: جيستشر
Gig: جيج
Graphic: جرافيك
Green: جرين
Growth: جروث
Hybrid: هايبرد
automation: أوتوميشن
campaign: كامبين
commerce: كومرس
control: كنترول
currency: كرنسي
design: ديزاين
footprint: فوتبرينت
hacking: هاكينج
key: كي
keyboard: كيبورد
memory: ميموري
recognition: ريكوجنيشن
systems: سيستمز
theory: ثيوري
tracker: تراكر
transformation: ترانسفورميشن
JavaScript: جافاسكريبت
Hyperlink: هايبرلينك
Phablet: فابلت
Canada: كندا
Qatar: قطر
Malaysia: ماليزيا
Oman: عمان
Kuwait: كويت
الBrazil: البرازيل
الMexico: المكسيك
London: لندن
Paris: باريس
Rome: روما
Berlin: برلين
Madrid: مدريد
Vienna: فيينا
Sydney: سيدني
Melbourne: ملبورن
Chicago: شيكاغو
New York: نيويورك
Toronto: تورونتو
Montreal: مونتريال
Los Angeles: لوس أنجلوس
San Francisco: سان فرانسيسكو
Miami: ميامي
Robotics: روبوتيكس
Telecommuting: تيليكوميوتينج
Podcasting: بودكاستينج
SaaS: ساس
Nanotechnology: نانوتكنولوجي
IT: آي تي
consultant: كونسلتنت
Peer-to-peer: بير تو بير
Open source: أوبن سورس
Machine-to-machine: ماشين تو ماشين
Influencer: إنفلونسر
Information: إنفورميشن
Innovation: إنوفيشن
Instant: إنستنت
Interactive: إنتراكتيف
Knowledge: نوليدج
Meta: ميتا
Mobile: موبايل
Natural: ناتشرال
Neural: نيورال
Operating: أوبريتينج
Personal: بيرسونال
Predictive: بريديكتيف
Quantum: كوانتم
Quick: كويك
assistant: أسيستنت
banking: بانكينج
code: كود
engine: إنجن
graph: جراف
lab: لاب
language: لانجويج
marketing: ماركيتينج
media: ميديا
messaging: ميسجينج
processing: بروسيسينج
response: ريسبونس
search: سيرش
startup: ستارت
superhighway: سوبرهايواي
Real-time: ريل-تايم
Software as a Service: سوفتوير أز أ سيرفيس
Real: ريل
Remote: ريموت
Responsive: ريسبونسيف
Retail: ريتيل
Service: سيرفيس
Sharing: شيرينج
Silicon: سيليكون
Social: سوشال
Solid: سوليد
Startup: ستارتأب
Valley: فالي
attack: أتاك
city: سيتي
drive: درايف
incubator: إنكوبيتر
networking: نتوركينج
optimization: أوبتيمايزيشن
resources: ريسورسز
services: سيرفيسز
state: ستيت
therapy: ثيرابي
time: تايم
work: ورك
Supply: سبلاي
Sustainable: سستينابل
User: يوزر
Venture: فينتشر
Voice: فويس
Wearable: ويرابل
Web: ويب
Wireless: وايرلس
Wire: واير
Zero: زيرو
capital: كابيتال
chain: تشين
charging: تشارجينج
day: داي
degree: ديجري
development: ديفيلوبمنت
exploit: إكسبلويت
over: أوفر
private: برايفت
hi: هاي
bye: باي
powder: باودر
baking: بيكنج
الsocial: السوشيال
الsocial: السوشال
dollar: دولار
screen: سكرين
shot: شوت
للprivate: للبرايفت
manchester: مانشستر
house: هاوس
of: اوف
fashions: فاشونز
food: فود
dubai: دبي